#########################
#!..........#######....*#
#..####..............#..#
#...<##..####..#..#.....#
#..####..####..#..#.....#
#....................#..#
#..#..#..#######..#.....#
#..#..#..#.!####..#.....#
#..#..#..#..####..####..#
#.......................#
#..#######..##########..#
#..........!#.....#.....#
#..#..#######.....#..####
#..#..#........#..#..####
#..#..#..#######..#..####
#>.....................!#
#########################