--------------------
-    <             -
-                  -
-    >             -
-                  -
-                  -
-                  -
-    !             -
-                  -
-          *       -
-                  -
-                  -
-                  -
-                  -
--------------------