--------------------
-*                 -
-                  -
-         *        -
-                  -
-    <   >         -
-                  -
-            !     -
-                  -
--------------------