#########################
#*..........####.......<#
#..####.....####..#..#..#
#.................#.....#
#..####..####..#..#..#..#
#..####.......!#........#
#..####..####..####..#..#
#.......................#
#....!...####..####..#..#
#.......................#
#######..#..#..######...#
#........#..#...........#
#..####..#..#..#.....#..#
#..............#....!#..#
#####....####..#..####..#
#####..................>#
#########################